11111111111111111111111111111111111111
10000000000000000000000000000000000001
100000000000000000000000C00E1000000001
10000000000000000000000001111000000001
10000000000000000000000000001000000001
10000000000000000000000011111000000001
10000000000000000000000000001000000001
10000000000000000000001111111000000001
10000000000000000000000000001000000001
10000000000000000000011111111000000001
10000000000000000000000000001000000001
10000000000000000001111111111000000001
10000000000000000000000000001000000001
10000000000000000111111111111000000001
100000000000000000CCCCCCCCCC1000000001
10000000000000011111111111111000000001
1000P000000000000000000000001000000001
11111111111111111111111111111111111111