1111111111111111111
10000000C0000001111
1001011111000001111
1X010000C0000001111
1001000000000011111
10001111101100000C1
1P011000000C0000001
100E000000000000001
10011111111000000C1
1000000C00000001111
1001C00000000001111
1111111111111111111